..O....O....O..
.OOO..OOO..OOO.
..O....O....O..
...............
....O....O....O
...OOO..OOO..OO
....O....O....O
